BALL	B AO L
BLUE	B L UW
DO	D UW
FETCH	F EH CH
FOLLOW	F AA L OW
GREEN	G R IY N
HELLO	HH AH L OW
HELLO(2)	HH EH L OW
ME	M IY
NO	N OW
RED	R EH D
ROBOT	R OW B AA T
ROBOT(2)	R OW B AH T
SEE	S IY
STOP	S T AA P
THE	DH AH
THE(2)	DH IY
TOOTHPASTE	T UW TH P EY S T
TRACK	T R AE K
WHAT	W AH T
WHAT(2)	HH W AH T
YELLOW	Y EH L OW
YES	Y EH S
YOU	Y UW
